111111111111111111111111111
000000000000000000000000001
000000000000000000000000001
000000000000000000000000001
000000000000000000000000001
000000000000000000000000001
000000000000000000000000001
000000000000000000000000001
000000000000000000000000001
000000000000000000000000001
000000000000000000000000011
000000000000000000000000010
000000000000000000000000011
000000000000000000000000001
