111100000000000000000000000
000100000000000000000000000
000111110000000000000000000
000000011100000000000000000
000000000111111100000000000
000000000000001111000000000
000000000000000011110000000
000000000000000000111000000
000000000000000000001100000
000000000000000000000111000
000000000000000000000001100
000000000000000000000000100
000000000000000000000000111
000000000000000000000000001
