000111100111111111111111111
100101011001000000000000001
101101001101111011111111101
101001110111001010010001001
101001010100001010000011111
111100100100111010111000101
000100111110100010101001101
111100100100101110101100101
010111110100100010100111011
010000000100110000100001100
111110010000011111101000100
010101111001001000001110100
010101000011111111001010110
111111100000001001111010011
