011110010011111111110000000
000010010010000000011110000
010010010010001000000011000
010011111010001000000011000
010010000010001111111110000
010111000010000000000000000
010111111100000000000000000
010011111111111111111111110
011110000000000001111110011
110011111111000000000000001
111111100011111110000000001
000001111111111111111100001
000001110000111000110111001
000000011100001111111111001
