111111111111111111111111111
000000000000000000000000001
000000000000000000000000001
000000000000000000000000001
000000000000000000000000001
000001100000000000000000001
000001000000000000000000011
000001000000000000000000010
000001000000000000000000010
000000100000000000000000010
000000010000000000000000010
000000001110000000000000011
000000000001111000000000001
000000000000001111000000001
