111001111001111111111111111
001001001101000000001000011
011001000101001111001000000
110001000101011001101011110
100001110101010000101010010
100011010101010000100010010
101110010101010110100110010
111000010111011100100100010
100000010100010000111100110
100011010111010000011000100
100010010001111100000000110
111010011100000110100000010
001110000101100010111111011
000011100111100011100011001
