011111111100000000000000000
000000000111110000000000000
000000000001110000000000000
000000000000111000000000000
000000000000111100000000000
000000000000000111100000000
000000000000000001110000000
000000000000000000111000000
000000000000000000011000000
000000000000000000001100000
000000000000000000000111000
000000000000000000000001110
000000000000000000000000110
000000000000000000000000011
