111100111111111111111100000
000110100000000100000110111
100010111111110110011010101
100011000000010010110010101
111110011110010010100111101
000011010010111010100100001
110110010011101010100101111
010100111000000010110101001
011100101100111010100101001
111001110100101110100101000
100011010110000001101101110
110010000011110101011000011
011110111001010101010001101
010011101101011101111111001
