111110000000000000010000000
000011110000000011110000000
000000011111111111110011000
000001101110000111110110000
000001011000000111011100000
000001111111111111110000000
000001100000110001111000000
000001000011111111111000000
000001100010110001101100000
000000110011100001111100000
000000111010000111111111111
000000001111111101000000011
000000000000000000000000010
000000000000000000000000111
