111111100000000000000000000
000001100000000000000000000
000001110000000000000000000
000000111100000000000000000
000000011111000000000000000
000000000111111000000000000
000000000000111111000000000
000000000000000111111000000
000000000000000000011111000
000000000000000000011101100
000000000000000000000000110
000000000000000000000000010
000000000000000000000000011
000000000000000000000000001
