011111111111000000000000000
000000000001000000000000000
000000000001100000000000000
000000000000111110000000000
000000000000000110000000000
000000000000000010000000000
000000000000000011000000000
000000000000000001110000000
000000000000000000011000000
000000000000000000001100000
000000000000000000000111000
000000000000000000000001100
000000000000000000000000111
000000000000000000000000001
