111111111111111111111100000
000000001101111111111111000
000000010001111111111101000
000000100010011100000110100
000011000001101100000011100
000010000000111110000011100
000011000000101001100110100
000000100000101000101101000
000000011000011111011010000
000000000101001111110100000
000000000000111111111000000
000000000000000011110000000
000000000000000011001000000
000000000000000001111111111
