110000000000000000000000000
011000000000000000000000000
001111000000000000000000000
000001000000000000000000000
000001100000000000000000000
000000111000000000000000000
000000001111111111000000000
000000000000000001111111000
000000000000000000000001100
000000000000000000000000110
000000000000000000000000010
000000000000000000000000011
000000000000000000000000001
000000000000000000000000001
