011100000000000000000000000
011111100000000000000000000
000001111110000000000000000
000000000011111000000000000
000000000000011100000000000
000000000000001110000000000
000000000000000111000000000
000000000000000001100000000
000000000000000000110000000
000000000000000000111000000
000000000000000000111110000
000000000000000000100011110
000000000000000000000000011
000000000000000000000000001
