011011000001100000000000000
001111111011100000011011111
001000001110111110111110000
001011000100010011100100000
001110000110110010100100000
001000000011100111000111100
111110110011001101100011100
000000110001000111100000110
000000111111000101010000110
000111110000000101011000100
000100011100011101001111111
001100000111110001100010001
011000000000000000111111101
010000000000000000000000101
