011101101010110101011100000
000110001110000000100011000
001010111110111111110000110
001010111000001111111100011
010011010000001111010100010
100001110001111111110100010
100001011011110001001000010
100000001111000001010000010
100001001111111001000000010
110001011001111111100000010
000101110000101111111100100
000001101010000001100111100
000000100000000000001111110
000000010000000001100000011
