111111100000000000000000000
000000110000000000000000000
000000111100000000000000000
000000001111111000000000000
000000000000111110000000000
000000000000001111000000000
000000000000000001110000000
000000000000000000011100000
000000000000000000000111000
000000000000000000000011000
000000000000000000000001100
000000000000000000000000110
000000000000000000000000011
000000000000000000000000001
