111111100000000000000000000
000001100000000000011000000
000011011111000111111000000
000111110001011100011000000
000111111111110000001000000
000000000110011000001100000
000000001111100000101100000
000000011110000000001100000
000000001100001000011100000
000000111111111001110100000
000000000011001111100110000
000000000000000000000011000
000000000000000000000001100
000000000000000000000000111
