110000000000000000000000000
010001110000000000000100000
011101010011110011111100000
010101001010010000100100000
010111100010110000100111110
010000100110100000100000000
010000100010111100000111000
010000111110000111100101000
110000000010000100100101111
110000000011100100111100001
011111100000100101000000001
100001000000111101011110111
101101111111000001111000100
000001000000000000001000111
