011111000000000000000000000
000001000000000000011000000
000001100000000001110000000
000000100000000111000000000
000000100000001100000000000
000000100000110000000000000
000000110011100000000011100
000000011110000000000111000
000001110000000000001010000
000011011000000000110110000
000010001100000011111111000
000010000111111110111101110
000010000000000000000000011
000011111111000000000000001
