100000000000000000000000000
100000000000000000110000000
100000000000000000111000000
111111111111100000101000000
000010000000100000101100000
010110000000100000100100000
110100000000100001100110000
100100000000100001000011000
101101000000110001111111000
101101000000010000000000000
100101100000010000000000000
101100100010011000000000011
111000111110001111111111111
011000000000000000000000001
