111000000000000000000000000
001000000000000000000000000
001000000000000000001111000
001000000000000001111000000
001000000000001110000000000
001000000000110000001110000
001111000011010000001110000
000001111111100000011100000
000000100111110000011000000
000010000001111110110111100
011100000000011111111111100
010000000000000000000001110
000000000000000000000000011
000000000000000000000000001
