101011111000100010100111010
110001000100111011111011111
110011111110100111110010001
010010000010100100010111111
011110000010111101010100101
010001111110100011010110101
011101000000101000010101101
010011111111111111010100001
010010000000100001011101111
010010111010100111001001010
010010000010100000001001110
011111111100111111111101000
000000000111010000001001111
000000000000011111101110001
