100000000000000000000011000
100000000111111000000001100
100000001100001111000100100
100000001000000001000100110
111111001000000011000101100
001001001001101110001111000
001001111001111011111010000
001000110001000110000010000
001100011101000100000010000
000100000111000111000001000
001100000001100001100001000
001000000000100000110001000
111000000000111000010001000
000000000000001111111111111
