000000000000000000000000000
111000000000000000000000000
001000000000000000000000000
001000001110000000000000000
001100001011100000000000000
000110111000100000000000000
000011100000100000000000000
000000000000100000000000000
000000000000100000111111100
000000000000110000100000100
000000000000011000100001100
000000000000001100100001000
000000000000000101100001000
000000000000000111000001111
