111100000000000000000000000
000111000000000000000000000
110101000000000000000000000
010101100000000000000000000
010101111100000000000000000
110101000111100000000000000
100001000000111110000000000
101111000000000111100000000
101111000000000000110000000
100001000000000000011100000
111101000000000000000111000
111101000000000000000001100
100001100000000000000000110
111111100000000000000000011
